........
..***...
....0...
........
.x......
.x......
.x...0..
........
